TAG	TEXT	COMMENT
ACCESSIBILITY_WELCOME_TO_HEARTHSTONE	Bienvenido a Hearthstone	
	
ACCESSIBILITY_PRESS_KEY_TO_START	Pulsa {0} para iniciar	0=key e.g. Press Enter to start
ACCESSIBILITY_PRESS_KEY_TO_CONTINUE	Pulsa {0} para continuar	0=key e.g. Press Enter to continue
ACCESSIBILITY_PRESS_KEY_TO_FINISH	Pulsa {0} para finalizar	0=key e.g. Press Enter to finish
ACCESSIBILITY_PRESS_KEY_TO_EXIT	Pulsa {0} para cerrar	0=key e.g. Press Enter to exit
ACCESSIBILITY_PRESS_KEY_ONCE_DONE	pulsa {0} una vez que hayas terminado	0=key e.g. Press Enter once you're done

ACCESSIBILITY_MENU_HELP_NO_BACK_BUTTON	Utiliza las flechas arriba y abajo para navegar por el menú. Pulsa {0} para seleccionar una opción	0=Enter key
ACCESSIBILITY_MENU_HELP_WITH_BACK_BUTTON	Utiliza las flechas arriba y abajo para navegar por el menú. Pulsa {0} para seleccionar una opción. Pulsa {1} para regresar	0=Enter key 1=Backspace key
ACCESSIBILITY_MENU_OPTION_FORMAT	{0} {1} de {2}	0=option name 1=option number 2=options count e.g. Options 1 of 2

ACCESSIBILITY_OPTIONS_MENU_TITLE	Menú de opciones	
ACCESSIBILITY_OPTIONS_MENU_MASTER_VOLUME_OPTION	Ajustar el volumen general	
ACCESSIBILITY_OPTIONS_MENU_FULLSCREEN_OPTION	Activar pantalla completa	
ACCESSIBILITY_OPTIONS_MENU_ADJUST_MASTER_VOLUME	Utiliza las flechas izquierda y derecha para ajustar el volumen	
ACCESSIBILITY_OPTIONS_MENU_FULLSCREEN_ON	Pantalla completa activada	
ACCESSIBILITY_OPTIONS_MENU_FULLSCREEN_OFF	Pantalla completa desactivada	
ACCESSIBILITY_HUB_MAIN_MENU_TITLE	Menú principal	
ACCESSIBILITY_HUB_MAIN_MENU_OPTION_HELP	Pulsa {0} en cualquier momento si no sabes como proceder, te llevará al menú del juego. Si necesitas ayuda de una persona sin problemas de visión puedes desactivar la accesibilidad pulsando {1}. Esto le permitirá controlar el juego normalmente utilizando el mouse. Recuerda pulsar {1} cuando quieras reactivar la accesibilidad	0=Esc key 1=F8 key 

ACCESSIBILITY_GLOBAL_LOADING_GAME	Cargando juego	
ACCESSIBILITY_GLOBAL_CLOSING_GAME	Cerrando el juego	
ACCESSIBILITY_GLOBAL_GAME_LOADED	Juego cargado	
ACCESSIBILITY_GLOBAL_LOADING	Cargando	
ACCESSIBILITY_GLOBAL_PLEASE_WAIT	Espera por favor	
ACCESSIBILITY_GLOBAL_CARD	Carta	
ACCESSIBILITY_GLOBAL_CARD_PLURAL	Cartas	
ACCESSIBILITY_GLOBAL_HERO	Héroe	
ACCESSIBILITY_GLOBAL_HERO_POWER	Poder de héroe	
ACCESSIBILITY_GLOBAL_GAME_SPEED	Velocidad del juego {0}	0=current game speed
ACCESSIBILITY_GLOBAL_NEW_HEARTHSTONE_ACCESS_VERSION_AVAILABLE	Hay una nueva versión disponible de Hearthstone Access. Ejecuta el parche de nuevo siempre que sea posible, ya que puede contener correcciones de errores u otras novedades.	

ACCESSIBILITY_FORMATTING_PERIOD	.	
ACCESSIBILITY_FORMATTING_SENTENCE_ENDING_CHARACTERS	.!?;	
ACCESSIBILITY_FORMATTING_LIST_SEPARATOR	, 	e.g. the ", " in A, B, C, D and E
ACCESSIBILITY_FORMATTING_LIST_FINAL_SEPARATOR	 y 	e.g. the " and " in A, B, C, D and E

ACCESSIBILITY_FORMATTING_ORDINAL_NUMBER_1	número 1	Languages with grammatical genders can work around using digits and configure text that uses ordinal numbers such as "minion number 1" instead of "first minion"
ACCESSIBILITY_FORMATTING_ORDINAL_NUMBER_2	número 2	
ACCESSIBILITY_FORMATTING_ORDINAL_NUMBER_3	número 3	
ACCESSIBILITY_FORMATTING_ORDINAL_NUMBER_4	número 4	
ACCESSIBILITY_FORMATTING_ORDINAL_NUMBER_5	número 5	
ACCESSIBILITY_FORMATTING_ORDINAL_NUMBER_6	número 6	
ACCESSIBILITY_FORMATTING_ORDINAL_NUMBER_7	número 7	
ACCESSIBILITY_FORMATTING_ORDINAL_NUMBER_8	número 8	
ACCESSIBILITY_FORMATTING_ORDINAL_NUMBER_9	número 9	
ACCESSIBILITY_FORMATTING_ORDINAL_NUMBER_10	número 10	

ACCESSIBILITY_INPUT_COMMAND_WITH_MODIFIER_FORMAT	Shift + {0}	0=key e.g. Shift + F
ACCESSIBILITY_INPUT_KEY_OVERRIDE_Return	Enter	Optional. Overrides the Return key to be read as Enter by TTS
ACCESSIBILITY_INPUT_KEY_OVERRIDE_A	a	Optional. Overrides the A key to be read as eh by TTS
ACCESSIBILITY_INPUT_KEY_OVERRIDE_I	i	Optional. Overrides the I key to be read as eye by TTS

ACCESSIBILITY_READ_CARD_COST	{0} mana	0=card cost
ACCESSIBILITY_READ_CARD_ATK_HEALTH	{0} {1}	0=attack 1=health e.g. 3 2
ACCESSIBILITY_READ_CARD_ATK_DURABILITY	{0} {1}	0=attack 1=durability e.g. 1 3
ACCESSIBILITY_READ_HERO_CARD_ATK	{0} de ataque	0=attack
ACCESSIBILITY_READ_HERO_CARD_HEALTH	{0} de salud	0=health
ACCESSIBILITY_READ_HERO_CARD_ARMOR	{0} de armadura	0=armor
ACCESSIBILITY_READ_CARD_N_COPIES	{0} copias	0=number of copies
ACCESSIBILITY_READ_COLLECTION_CARD_NAME_GOLDEN	{0} - edición dorada	0=card name e.g. {fireball} - golden edition
ACCESSIBILITY_READ_COLLECTION_CARD_NAME_DIAMOND	{0} - edición diamante	0=card name

ACCESSIBILITY_GAMEPLAY_OPPONENT_TURN	Turno del oponente	
ACCESSIBILITY_GAMEPLAY_TURN_ENDED	Turno terminado	
ACCESSIBILITY_GAMEPLAY_CARD_IN_ZONE_TRIGGERED	El efecto de {0} se ha activado	0=full card name in zone e.g. {Your second Murloc Raider} triggered
ACCESSIBILITY_GAMEPLAY_PLAYER_CARD_TRIGGERED	El efecto de tu {0} se ha activado	0=card name e.g. Your {Psyfiend} triggered
ACCESSIBILITY_GAMEPLAY_OPPONENT_CARD_TRIGGERED	El efecto de {0} del oponente se ha activado	0=card name e.g. Your opponent's {Psyfiend} triggered
ACCESSIBILITY_GAMEPLAY_OPPONENT_CARD_TRIGGERED_BIG_CARD	El efecto de {0} del oponente se ha activado; {1}	0=card name 1=cardText e.g. Your opponent's {Psyfiend} triggered; {After you cast a Shadow spell, deal 2 damage to each Hero.}
ACCESSIBILITY_GAMEPLAY_PLAYER_PLAYED_CARD	Jugaste {0}	0=card name e.g. You played {Fireball}
ACCESSIBILITY_GAMEPLAY_PLAYER_PLAYED_CARD_BIG_CARD	Jugaste {0}; {1}	0=card name 1=card text e.g. You played {Fireball}; {Deal 6 damage.}
ACCESSIBILITY_GAMEPLAY_OPPONENT_PLAYED_CARD	Tu oponente jugó {0}	0=card name e.g. Your opponent played {Fireball}
ACCESSIBILITY_GAMEPLAY_OPPONENT_PLAYED_CARD_BIG_CARD	Tu oponente jugó {0}; {1}	0=card name 1=card text e.g. Your opponent played {Fireball}; {Deal 6 damage.}
ACCESSIBILITY_GAMEPLAY_PLAYER_SUMMONED_MINION	Invocaste {0}	0=minion name e.g. You summoned {Raid Leader}
ACCESSIBILITY_GAMEPLAY_PLAYER_SUMMONED_MINION_BIG_CARD	Invocaste {0}; {1} {2} {3}	0=minion name 1=attack 2=health 3=card text e.g. You summoned {Raid Leader}; {2} {3} {Your other minions have +1 Attack.}
ACCESSIBILITY_GAMEPLAY_OPPONENT_SUMMONED_MINION	Tu oponente invocó {0}	0=minion name e.g. Your opponent summoned {Raid Leader}
ACCESSIBILITY_GAMEPLAY_OPPONENT_SUMMONED_MINION_BIG_CARD	Tu oponente invocó {0}; {1} {2} {3}	0=minion name 1=attack 2=health 3=card text e.g. Your opponent summoned {Raid Leader}; {2} {3} {Your other minions have +1 Attack.}
ACCESSIBILITY_GAMEPLAY_PLAYER_EQUIPPED_WEAPON	Te equipaste {0}	0=weapon name e.g. You equipped {Aldrachi Warblades}
ACCESSIBILITY_GAMEPLAY_PLAYER_EQUIPPED_WEAPON_BIG_CARD	Te has equipado {0}; {1} {2} {3}	0=weapon name 1=attack 2=durability 3=card text e.g. You equipped {Aldrachi Warblades}; {2} {2} {Lifesteal}
ACCESSIBILITY_GAMEPLAY_OPPONENT_EQUIPPED_WEAPON	Tu oponente se equipó {0}	0=weapon name e.g. Your opponent equipped {Aldrachi Warblades}
ACCESSIBILITY_GAMEPLAY_OPPONENT_EQUIPPED_WEAPON_BIG_CARD	Tu oponente se equipó {0}; {1} {2} {3}	0=weapon name 1=attack 2=durability 3=card text e.g. Your opponent equipped {Aldrachi Warblades}; {2} {2} {Lifesteal}
ACCESSIBILITY_GAMEPLAY_PLAYER_USED_HERO_POWER	Usaste {0}	0=hero power name e.g. You used {Fireblast}
ACCESSIBILITY_GAMEPLAY_PLAYER_USED_HERO_POWER_BIG_CARD	Usaste {0}; {1}	0=hero power name 1=card text e.g. You used {Fireblast}; {Hero Power Deal 1 damage.}
ACCESSIBILITY_GAMEPLAY_OPPONENT_USED_HERO_POWER	Tu oponente usó {0}	0=hero power name e.g. Your opponent used {Fireblast}
ACCESSIBILITY_GAMEPLAY_OPPONENT_USED_HERO_POWER_BIG_CARD	Tu oponente usó {0}; {1}	0=hero power name 1=card text e.g. Your opponent used {Fireblast}; {Hero Power Deal 1 damage.}
ACCESSIBILITY_GAMEPLAY_PLAYER_CAST_SECRET	Colocaste {0}	0=secret name e.g. You cast {Counterspell}
ACCESSIBILITY_GAMEPLAY_PLAYER_CAST_SECRET_BIG_CARD	Colocaste {0}; {1}	0=secret name 1=card text e.g. You cast {Counterspell}; {Secret: When your opponent casts a spell, Counter it.}
ACCESSIBILITY_GAMEPLAY_OPPONENT_CAST_SECRET	Tu oponente colocó un secreto de {0}	0=secret class e.g. Your opponent cast 1 {mage} secret
ACCESSIBILITY_GAMEPLAY_OPPONENT_CAST_N_SECRETS	Tu oponente colocó {0} secretos	0=number of secrets e.g. Your opponent cast {2} secrets
ACCESSIBILITY_GAMEPLAY_PLAYER_DREW_CARD_FROM_EMPTY_DECK	¡Intentaste robar una carta de un mazo vacío!	
ACCESSIBILITY_GAMEPLAY_OPPONENT_DREW_CARD_FROM_EMPTY_DECK	¡Tu oponente intentó robar una carta de un mazo vacío!	
ACCESSIBILITY_GAMEPLAY_PLAYER_DREW_CARD_BUT_BURNED	¡robaste 1 {0} pero se quemó!	0=card e.g. You drew 1 {Fireball} but it burned
ACCESSIBILITY_GAMEPLAY_OPPONENT_DREW_CARD_BUT_BURNED	¡Tu oponente robó 1 {0} pero se quemó!	0=card e.g. Your opponent drew 1 {Fireball} but it burned
ACCESSIBILITY_GAMEPLAY_ENTITY_ATTACKED	{0} atacó a {1}	0=attacker name 1=defender name e.g. {Your Murloc Raider} attacked {your opponent's Hero}
ACCESSIBILITY_GAMEPLAY_ENTITY_ATTACKED_OTHER	{0} intentó atacar a {1} pero atacó a {2} en su lugar!	0=attacker name 1=proposed defender name 2=real defender name e.g. {Your Murloc Raider} attempted to attack {your opponent's Hero} but attacked {your opponent's Bloodfen Raptor} instead

ACCESSIBILITY_GAMEPLAY_PLAYER_TURN_START_READ_MANA	Tienes{0} maná	0=mana
ACCESSIBILITY_GAMEPLAY_YOU_GO_FIRST	Vas primero	
ACCESSIBILITY_GAMEPLAY_OPPONENT_GOES_FIRST	Tu oponente va primero	
ACCESSIBILITY_GAMEPLAY_YOU_START_WITH_N_CARDS	Comienzas con {0} |4(carta,cartas)	0=number of cards
ACCESSIBILITY_GAMEPLAY_PLAYER_DREW_CARDS	Robaste {0}	0=card names e.g. You drew {1 Bloodfen Raptor and 1 Murloc Raider}
ACCESSIBILITY_GAMEPLAY_OPPONENT_DREW_CARDS	Tu oponente robó {0}	0=card names e.g. Your opponent drew {1 Bloodfen Raptor and 1 Murloc Raider}
ACCESSIBILITY_GAMEPLAY_PLAYER_DISCARDED_CARDS	Descartaste {0}	0=card names e.g. You discarded {1 Bloodfen Raptor and 1 Murloc Raider}
ACCESSIBILITY_GAMEPLAY_OPPONENT_DISCARDED_CARDS	Tu oponente descartó {0}	0=card names e.g. Your opponent discarded {1 Bloodfen Raptor and 1 Murloc Raider}
ACCESSIBILITY_GAMEPLAY_YOU_GET_THE_COIN	Tomas la moneda	
ACCESSIBILITY_GAMEPLAY_WAITING_FOR_OPPONENT	Esperando a tu oponente	
ACCESSIBILITY_GAMEPLAY_QUERY_SUMMON_MINION	¿Invocar?	
ACCESSIBILITY_GAMEPLAY_QUERY_SUMMON_MINION_AT_THE_RIGHT	¿Invocar a la derecha?	
ACCESSIBILITY_GAMEPLAY_QUERY_SUMMON_MINION_AT_THE_LEFT	¿Invocar a la izquierda?	
ACCESSIBILITY_GAMEPLAY_QUERY_SUMMON_MINION_BETWEEN	¿Invocar entre {0} y {1}?	Summon between {Murloc Raider} and {Bloodfen Raptor}?
ACCESSIBILITY_GAMEPLAY_QUERY_PLAY_CARD	¿Jugar carta?	
ACCESSIBILITY_GAMEPLAY_QUERY_END_TURN_WHEN_VALID_PLAYS	Aún tienes jugadas válidas. ¿Estás seguro?	
ACCESSIBILITY_GAMEPLAY_SEND_TO_FACE_NO_MINIONS	No tienes esbirros invocados	
ACCESSIBILITY_GAMEPLAY_SEND_TO_FACE_HERO_CANT_BE_ATTACKED	El héroe de tu oponente no puede ser atacado	
ACCESSIBILITY_GAMEPLAY_SEND_TO_FACE_HERO_CANT_BE_TARGETED	El héroe de tu oponente no puede ser el objetivo	
ACCESSIBILITY_GAMEPLAY_SEND_TO_FACE_HERO_NO_VALID_ATTACKERS	Ninguno de tus esbirros puede atacar al héroe de tu oponente	
ACCESSIBILITY_GAMEPLAY_CHOOSE_TARGET	Elige un objetivo	

ACCESSIBILITY_GAMEPLAY_SEE_ZONE_PLAYER_HAND_EMPTY	Tu mano esta vacía	
ACCESSIBILITY_GAMEPLAY_SEE_ZONE_PLAYER_MINIONS_EMPTY	No tienes esbirros invocados	
ACCESSIBILITY_GAMEPLAY_SEE_ZONE_OPPONENT_MINIONS_EMPTY	Tu oponente no tiene esbirros invocados	
ACCESSIBILITY_GAMEPLAY_SEE_ZONE_PLAYER_SECRETS_EMPTY	No tienes secretos colocados	
ACCESSIBILITY_GAMEPLAY_SEE_ZONE_OPPONENT_SECRETS_EMPTY	Tu oponente no tiene secretos colocados	
ACCESSIBILITY_GAMEPLAY_SEE_ZONE_OPPONENT_SECRETS_COUNT	Tu oponente tiene {0} |4(secreto colocado,secretos colocados)	0=number of secrets
ACCESSIBILITY_GAMEPLAY_SEE_ZONE_PLAYER_HERO_POWER_EMPTY	No tienes poder de héroe	
ACCESSIBILITY_GAMEPLAY_SEE_ZONE_OPPONENT_HERO_POWER_EMPTY	Tu oponente no tiene poder de héroe	
ACCESSIBILITY_GAMEPLAY_SEE_ZONE_PLAYER_WEAPON_EMPTY	No tienes un arma equipada	
ACCESSIBILITY_GAMEPLAY_SEE_ZONE_OPPONENT_WEAPON_EMPTY	Tu oponente no tiene un arma equipada	
ACCESSIBILITY_GAMEPLAY_READ_PLAYER_MANA_CURRENT_AND_TOTAL	Tienes {0} de {1} mana	0=current mana 1=total mana
ACCESSIBILITY_GAMEPLAY_READ_PLAYER_MANA	Tienes {0} mana	0=current and total mana
ACCESSIBILITY_GAMEPLAY_READ_OPPONENT_MANA	Tu oponente tiene {0} mana	0=current and total mana
ACCESSIBILITY_GAMEPLAY_READ_OPPONENT_HAND	Mano del oponente. {0} |4(carta,cartas)	0=number of cards
ACCESSIBILITY_GAMEPLAY_READ_PLAYER_DECK	Mazo. {0} |4(carta,cartas)	0=number of cards
ACCESSIBILITY_GAMEPLAY_READ_OPPONENT_DECK	Mazo del oponente. {0} |4(carta,cartas)	0=number of cards
ACCESSIBILITY_GAMEPLAY_NO_MORE_VALID_OPTIONS	No hay más opciones válidas	
ACCESSIBILITY_GAMEPLAY_NO_VALID_PLAYS	No tienes jugadas válidas	

ACCESSIBILITY_GAMEPLAY_GAME_OVER_WON	Has ganado!	
ACCESSIBILITY_GAMEPLAY_GAME_OVER_LOST	Has perdido...	
ACCESSIBILITY_GAMEPLAY_GAME_OVER_TIED	Has empatado	
ACCESSIBILITY_GAMEPLAY_GAME_OVER_GENERIC	Fin del juego	

ACCESSIBILITY_GAMEPLAY_ZONE_PLAYER_HERO	Tu héroe	Read when you press v
ACCESSIBILITY_GAMEPLAY_ZONE_OPPONENT_HERO	Herue de tu oponente	Read when you press f
ACCESSIBILITY_GAMEPLAY_ZONE_PLAYER_HERO_POWER	Tu poder de héroe	Read when you press r
ACCESSIBILITY_GAMEPLAY_ZONE_OPPONENT_HERO_POWER	Poder de héroe de tu oponente	Read when you press Shift+r
ACCESSIBILITY_GAMEPLAY_ZONE_PLAYER_WEAPON	Tu arma	Read when you press w
ACCESSIBILITY_GAMEPLAY_ZONE_OPPONENT_WEAPON	Arma de tu oponente	Read when you press Shift+w
ACCESSIBILITY_GAMEPLAY_ZONE_PLAYER_HAND	Tu mano	Read when you press c
ACCESSIBILITY_GAMEPLAY_ZONE_OPPONENT_HAND	Mano de tu oponente	Read when you press Shift+c
ACCESSIBILITY_GAMEPLAY_ZONE_PLAYER_MINIONS	Tus esbirros	Read when you press b
ACCESSIBILITY_GAMEPLAY_ZONE_OPPONENT_MINIONS	Esvirros de tu oponente	Read when you press g
ACCESSIBILITY_GAMEPLAY_ZONE_PLAYER_SECRETS	Tus secretos	Read when you press s
ACCESSIBILITY_GAMEPLAY_ZONE_OPPONENT_SECRETS	Secretos de tu oponente	Read when you press Shift+s

ACCESSIBILITY_GAMEPLAY_DIFF_ZONE_PLAYER_HAND	Tu Mano	e.g. Your opponent's Murloc Raider moved from your opponent's hand to {your hand}
ACCESSIBILITY_GAMEPLAY_DIFF_ZONE_OPPONENT_HAND	la mano de tu oponente	e.g. Your Murloc Raider moved to {you opponent's hand}
ACCESSIBILITY_GAMEPLAY_DIFF_ZONE_PLAYER_BATTLEFIELD	tu campo	e.g. Your Murloc Raider moved from your graveyard to {your battlefield}
ACCESSIBILITY_GAMEPLAY_DIFF_ZONE_OPPONENT_BATTLEFIELD	el campo de tu oponente	e.g. Your Murloc Raider moved from your graveyard to {your battlefield}
ACCESSIBILITY_GAMEPLAY_DIFF_ZONE_PLAYER_SECRETS	tus secretos	e.g. Your Ice Block moved from your deck to {your secrets}
ACCESSIBILITY_GAMEPLAY_DIFF_ZONE_OPPONENT_SECRETS	los secretos de tu oponente	e.g. Your Ice Block moved from your deck to {your opponent's secrets}
ACCESSIBILITY_GAMEPLAY_DIFF_ZONE_PLAYER_DECK	tu mazo	e.g. Your Fireball moved from {your deck} to your opponent's deck
ACCESSIBILITY_GAMEPLAY_DIFF_ZONE_OPPONENT_DECK	El mazo de tu oponente	e.g. Your Fireball moved from your deck to {your opponent's deck}
ACCESSIBILITY_GAMEPLAY_DIFF_ZONE_PLAYER_GRAVEYARD	tu cementerio	e.g. Your Murloc Raider moved from {your graveyard} to your battlefield
ACCESSIBILITY_GAMEPLAY_DIFF_ZONE_OPPONENT_GRAVEYARD	el cementerio de tu oponente	e.g. Your opponent's Murloc Raider moved from {your opponent's graveyard} to your battlefield

ACCESSIBILITY_GAMEPLAY_MULLIGAN	Mulligan	
ACCESSIBILITY_GAMEPLAY_MULLIGAN_WILL_BE_REPLACED	Será reemplazada	
ACCESSIBILITY_GAMEPLAY_MULLIGAN_WILL_NOT_BE_REPLACED	No será reemplazada	
ACCESSIBILITY_GAMEPLAY_MULLIGAN_HELP	Utiliza las flechas para revisar tus cartas iniciales y {0} para marcar las que te gustaría reemplazar. Pulsa {1} una vez que hayas terminado	0=spacebar key 1=Enter key
ACCESSIBILITY_GAMEPLAY_MULLIGAN_HELP_WAITING_FOR_GAME_TO_START	El juego está a punto de empezar. Espera por favor	

ACCESSIBILITY_GAMEPLAY_DIFF_ENTITY_DIED	Fue destruído	Singular and plural are often the same in English
ACCESSIBILITY_GAMEPLAY_DIFF_MULTIPLE_ENTITIES_DIED	Fueron destruídos	Singular and plural are often the same in English
ACCESSIBILITY_GAMEPLAY_DIFF_WEAPON_BROKE	se rompió	
ACCESSIBILITY_GAMEPLAY_DIFF_ENTITY_TRANSFORMED	Se ha transformado en 1 {0}	0=name of the card it transformed into e.g. transformed into 1 {Sheep}
ACCESSIBILITY_GAMEPLAY_DIFF_MULTIPLE_ENTITIES_TRANSFORMED	Se han transformado en 1 {0}	0=name of the card it transformed into e.g. transformed into 1 {Sheep}
ACCESSIBILITY_GAMEPLAY_DIFF_ENTITY_TOOK_N_DAMAGE	Recibió {0} Daño	0=damage taken
ACCESSIBILITY_GAMEPLAY_DIFF_MULTIPLE_ENTITIES_TOOK_N_DAMAGE	Recibieron {0} daño	0=damage taken
ACCESSIBILITY_GAMEPLAY_DIFF_ENTITY_N_DURABILITY	{0} durabilidad	0=gained/lost durability amount
ACCESSIBILITY_GAMEPLAY_DIFF_ENTITY_N_ATTACK	{0} ataque	0=gained/lost attack amount
ACCESSIBILITY_GAMEPLAY_DIFF_ENTITY_N_HEALTH	{0} salud	0=gained/lost health amount
ACCESSIBILITY_GAMEPLAY_DIFF_ENTITY_N_ARMOR	{0} armadura	0=gained/lost armor amount
ACCESSIBILITY_GAMEPLAY_DIFF_ENTITY_RECOVERED_N_HEALTH	Recuperó {0} salud	0=recovered health
ACCESSIBILITY_GAMEPLAY_DIFF_MULTIPLE_ENTITIES_RECOVERED_N_HEALTH	Recuperaron {0} salud	0=recovered health
ACCESSIBILITY_GAMEPLAY_DIFF_ENTITY_BECAME_INVULNERABLE	se volvió invulnerable	
ACCESSIBILITY_GAMEPLAY_DIFF_MULTIPLE_ENTITIES_BECAME_INVULNERABLE	se volvieron invulnerables	
ACCESSIBILITY_GAMEPLAY_DIFF_ENTITY_BECAME_SILENCED	se silenció	
ACCESSIBILITY_GAMEPLAY_DIFF_MULTIPLE_ENTITIES_BECAME_SILENCED	se silenciaron	
ACCESSIBILITY_GAMEPLAY_DIFF_ENTITY_BECAME_DORMANT	entró en letargo	
ACCESSIBILITY_GAMEPLAY_DIFF_MULTIPLE_ENTITIES_BECAME_DORMANT	entraron en letargo	
ACCESSIBILITY_GAMEPLAY_DIFF_ENTITY_NO_LONGER_DORMANT	salió del letargo	
ACCESSIBILITY_GAMEPLAY_DIFF_MULTIPLE_ENTITIES_NO_LONGER_DORMANT	salieron del letargo	
ACCESSIBILITY_GAMEPLAY_DIFF_ENTITY_BECAME_FROZEN	se congeló	
ACCESSIBILITY_GAMEPLAY_DIFF_MULTIPLE_ENTITIES_BECAME_FROZEN	se congelaron	
ACCESSIBILITY_GAMEPLAY_DIFF_ENTITY_NO_LONGER_FROZEN	se descongeló	
ACCESSIBILITY_GAMEPLAY_DIFF_MULTIPLE_ENTITIES_NO_LONGER_FROZEN	se descongelaron	
ACCESSIBILITY_GAMEPLAY_DIFF_ENTITY_BECAME_IMMUNE	se volvió inmune	
ACCESSIBILITY_GAMEPLAY_DIFF_MULTIPLE_ENTITIES_BECAME_IMMUNE	se volvieron inmunes	
ACCESSIBILITY_GAMEPLAY_DIFF_ENTITY_NO_LONGER_IMMUNE	ya no es inmune	
ACCESSIBILITY_GAMEPLAY_DIFF_MULTIPLE_ENTITIES_NO_LONGER_IMMUNE	ya no son inmunes	
ACCESSIBILITY_GAMEPLAY_DIFF_ENTITY_BECAME_MAGNETIC	se magnetizó	
ACCESSIBILITY_GAMEPLAY_DIFF_MULTIPLE_ENTITIES_BECAME_MAGNETIC	se magnetizaron	
ACCESSIBILITY_GAMEPLAY_DIFF_ENTITY_NO_LONGER_MAGNETIC	se desmagnetizó	
ACCESSIBILITY_GAMEPLAY_DIFF_MULTIPLE_ENTITIES_NO_LONGER_MAGNETIC	se desmagnetizaron	
ACCESSIBILITY_GAMEPLAY_DIFF_ENTITY_BECAME_POISONOUS	adquirió veneno	
ACCESSIBILITY_GAMEPLAY_DIFF_MULTIPLE_ENTITIES_BECAME_POISONOUS	adquirieron veneno	
ACCESSIBILITY_GAMEPLAY_DIFF_ENTITY_NO_LONGER_POISONOUS	perdió su veneno	
ACCESSIBILITY_GAMEPLAY_DIFF_MULTIPLE_ENTITIES_NO_LONGER_POISONOUS	perdieron su veneno	
ACCESSIBILITY_GAMEPLAY_DIFF_ENTITY_BECAME_STEALTHED	adquirió sigilo	
ACCESSIBILITY_GAMEPLAY_DIFF_MULTIPLE_ENTITIES_BECAME_STEALTHED	adquirieron sigilo	
ACCESSIBILITY_GAMEPLAY_DIFF_ENTITY_GAINED_STATS	ganó {0}	0=stats e.g. gained {taunt, 3 attack and 2 health}
ACCESSIBILITY_GAMEPLAY_DIFF_MULTIPLE_ENTITIES_GAINED_STATS	ganaron {0}	0=stats e.g. gained {taunt, 3 attack and 2 health}
ACCESSIBILITY_GAMEPLAY_DIFF_ENTITY_LOST_STATS	perdió {0}	0=stats e.g. lost {taunt, 3 attack and 2 health}
ACCESSIBILITY_GAMEPLAY_DIFF_MULTIPLE_ENTITIES_LOST_STATS	perdieron {0}	0=stats e.g. lost {taunt, 3 attack and 2 health}

ACCESSIBILITY_GAMEPLAY_DIFF_ENTITY_SPEECHES_FORMAT	{0} {1}	0=entities 1=effect e.g. {Your Hero and your Raid Leader} {took 3 damage}

ACCESSIBILITY_GAMEPLAY_DIFF_PLAYER_ENTITY_FULL_NAME	tu {0}	0=entity name e.g. Your {Raid Leader}
ACCESSIBILITY_GAMEPLAY_DIFF_OPPONENT_ENTITY_FULL_NAME	{0} de tu oponente	0=entity name e.g. Your opponent's {Raid Leader}
ACCESSIBILITY_GAMEPLAY_DIFF_PLAYER_ENTITY_FULL_NAME_IN_LIST	Tu {1} {0}	0=ordinal number 1=entity name e.g. Your {second} {Raid Leader}
ACCESSIBILITY_GAMEPLAY_DIFF_OPPONENT_ENTITY_FULL_NAME_IN_LIST	{1} {0} de tu oponente	0=ordinal number 1=entity name e.g. Your opponent's {second} {Raid Leader}
ACCESSIBILITY_GAMEPLAY_DIFF_MULTIPLE_ENTITIES	{0} {1}	0=number of entities 1=entity name e.g. {2} {Raid Leader}

ACCESSIBILITY_GAMEPLAY_DIFF_GROUP_EVERYONE	todos	e.g. {everyone} took 2 damage
ACCESSIBILITY_GAMEPLAY_DIFF_GROUP_EVERYONE_ELSE	los demás	e.g. {everyone else} took 2 damage
ACCESSIBILITY_GAMEPLAY_DIFF_GROUP_ALL_MINIONS	todos los esbirros	e.g. {All minions} took 2 damage
ACCESSIBILITY_GAMEPLAY_DIFF_GROUP_ALL_OTHER_MINIONS	el resto de esbirros	e.g. {All other minions} took 2 damage
ACCESSIBILITY_GAMEPLAY_DIFF_GROUP_BOTH_HEROES	ambos héroes	e.g. {Both Heroes} took 2 damage
ACCESSIBILITY_GAMEPLAY_DIFF_GROUP_ENEMIES	Tus enemigos	e.g. {Your enemies} took 2 damage
ACCESSIBILITY_GAMEPLAY_DIFF_GROUP_OTHER_ENEMIES	Tus otros enemigos	e.g. {Your other enemies} took 2 damage
ACCESSIBILITY_GAMEPLAY_DIFF_GROUP_FRIENDLY_CHARACTERS	Tus personajes amistosos	e.g. {Your friendly characters} took 2 damage
ACCESSIBILITY_GAMEPLAY_DIFF_GROUP_OTHER_FRIENDLY_CHARACTERS	Los demás personajes amistosos	e.g. {Your other friendly characters} took 2 damage
ACCESSIBILITY_GAMEPLAY_DIFF_GROUP_OPPONENT_MINIONS	Los esbirros de tu oponente	e.g. {Your opponent's minions} took 2 damage
ACCESSIBILITY_GAMEPLAY_DIFF_GROUP_OTHER_OPPONENT_MINIONS	Los otros esbirros de tu oponente	e.g. {Your other opponent's minions} took 2 damage
ACCESSIBILITY_GAMEPLAY_DIFF_GROUP_FRIENDLY_MINIONS	Tus esbirros	e.g. {Your minions} took 2 damage
ACCESSIBILITY_GAMEPLAY_DIFF_GROUP_OTHER_FRIENDLY_MINIONS	Tus otros esbirros	e.g. {Your other minions} took 2 damage
ACCESSIBILITY_GAMEPLAY_DIFF_GROUP_FRIENDLY_SAME_NAME_ENTITIES	Tus {0} {1}	0=count 1=minion name e.g. Your {2} {Raid Leader}
ACCESSIBILITY_GAMEPLAY_DIFF_GROUP_OPPONENT_SAME_NAME_ENTITIES	{0} {1} de tu oponente	0=count 1=minion name e.g. Your opponent's {2} {Raid Leader}

ACCESSIBILITY_GAMEPLAY_DIFF_MOVEMENT_PLAYER_EQUIPPED_WEAPON	tu héroe equipó 1 {0}	0=weapon name e.g. your Hero equipped 1 {Fiery War Axe}
ACCESSIBILITY_GAMEPLAY_DIFF_MOVEMENT_OPPONENT_EQUIPPED_WEAPON	el héroe de tu oponente equipó 1 {0}	0=weapon name e.g. your opponent's Hero equipped 1 {Fiery War Axe}
ACCESSIBILITY_GAMEPLAY_DIFF_MOVEMENT_PLAYER_HERO_POWER_CHANGED	tu poder de héroe cambió a {0}	0=hero power name e.g. your Hero Power became {Fireblast}
ACCESSIBILITY_GAMEPLAY_DIFF_MOVEMENT_OPPONENT_HERO_POWER_CHANGED	el poder de héroe de tu oponente cambió a{0}	0=hero power name e.g. your opponent's Hero Power became {Fireblast}
ACCESSIBILITY_GAMEPLAY_DIFF_MOVEMENT_ENTITY_RETURNED_TO_PLAYER_HAND	volvió a tu mano	e.g. Your Bloodfen Raptor {returned to your hand}
ACCESSIBILITY_GAMEPLAY_DIFF_MOVEMENT_MULTIPLE_ENTITIES_RETURNED_TO_PLAYER_HAND	volvieron a tu mano	e.g. Your 2 Bloodfen Raptor {returned to your hand}
ACCESSIBILITY_GAMEPLAY_DIFF_MOVEMENT_ENTITY_RETURNED_TO_OPPONENT_HAND	volvió a la mano de tu oponente	e.g. Your Bloodfen Raptor {returned to your opponent's hand}
ACCESSIBILITY_GAMEPLAY_DIFF_MOVEMENT_MULTIPLE_ENTITIES_RETURNED_TO_OPPONENT_HAND	volvieron a la mano de tu oponente	e.g. Your 2 Bloodfen Raptor {returned to your opponent's hand}
ACCESSIBILITY_GAMEPLAY_DIFF_MOVEMENT_ENTITY_MOVED_FROM_ZONE_TO_ZONE	ha sido movido desde {0} a {1}	0=from zone name 1=to zone name e.g. Your Bloodfen raptor moved from {your hand} to {your opponent's deck}
ACCESSIBILITY_GAMEPLAY_DIFF_MOVEMENT_MULTIPLE_ENTITIES_MOVED_FROM_ZONE_TO_ZONE	han sido movidos desde {0} a {1}	0=from zone name 1=to zone name e.g. Your 2 Bloodfen raptor moved from {your hand} to {your opponent's deck}
ACCESSIBILITY_GAMEPLAY_DIFF_MOVEMENT_ENTITY_MOVED_TO_ZONE	ha sido movido a {0}	0=zone name e.g. Your Bloodfen Raptor moved to {your opponent's deck}
ACCESSIBILITY_GAMEPLAY_DIFF_MOVEMENT_MULTIPLE_ENTITIES_MOVED_TO_ZONE	han sido movidos a {0}	0=zone name e.g. Your 2 Bloodfen Raptor moved to {your opponent's deck}
ACCESSIBILITY_GAMEPLAY_DIFF_MOVEMENT_ENTITY_MOVED_ZONES_GENERIC	moved zones	e.g. Your Bloodfen Raptor {moved zones}
ACCESSIBILITY_GAMEPLAY_DIFF_MOVEMENT_MULTIPLE_ENTITIES_MOVED_ZONES_GENERIC	moved zones	e.g. Your 2 Bloodfen Raptor {moved zones}

ACCESSIBILITY_GAMEPLAY_DIFF_MOVEMENT_CARD_ADDED_TO_PLAYER_HAND	1 {0} se añadió a tu mano	0=card name e.g. 1 {Murloc Raider} was added to your hand
ACCESSIBILITY_GAMEPLAY_DIFF_MOVEMENT_CARDS_ADDED_TO_PLAYER_HAND	{0} se añadieron a tu mano	0=card names e.g. {2 Murloc Raider} were added to your hand
ACCESSIBILITY_GAMEPLAY_DIFF_MOVEMENT_CARD_ADDED_TO_OPPONENT_HAND	1 {0} se añadió a la mano de tu oponente	0=card name e.g. 1 {Murloc Raider} was added to your opponent's hand
ACCESSIBILITY_GAMEPLAY_DIFF_MOVEMENT_CARDS_ADDED_TO_OPPONENT_HAND	{0} se añadieron a la mano de tu oponente	0=card names e.g. {2 Murloc Raider} were added to your opponent's hand
ACCESSIBILITY_GAMEPLAY_DIFF_MOVEMENT_CARD_ADDED_TO_PLAYER_DECK	1 {0} se barajó en tu mazo	0=card name e.g. 1 {Fireball} was shuffled into your deck
ACCESSIBILITY_GAMEPLAY_DIFF_MOVEMENT_CARDS_ADDED_TO_PLAYER_DECK	{0} se barajaron en tu mazo	0=card names e.g. {2 Fireball} were shuffled into your deck
ACCESSIBILITY_GAMEPLAY_DIFF_MOVEMENT_CARD_ADDED_TO_OPPONENT_DECK	1 {0} se barajó en el mazo de tu oponente	0=card name e.g. 1 {Fireball} was shuffled into your opponent's deck
ACCESSIBILITY_GAMEPLAY_DIFF_MOVEMENT_CARDS_ADDED_TO_OPPONENT_DECK	{0} se barajaron en el mazo de tu oponente	0=card names e.g. {2 Fireball} were shuffled into your opponent's deck
ACCESSIBILITY_GAMEPLAY_DIFF_MOVEMENT_CARD_ADDED_TO_PLAYER_BATTLEFIELD	1 {0} se invocó en tu campo	0=card name e.g. 1 {Murloc Raider} was summoned into your battlefield
ACCESSIBILITY_GAMEPLAY_DIFF_MOVEMENT_CARDS_ADDED_TO_PLAYER_BATTLEFIELD	{0} se invocaron en tu campo	0=card names e.g. {2 Murloc Raider} were summoned into your battlefield
ACCESSIBILITY_GAMEPLAY_DIFF_MOVEMENT_CARD_ADDED_TO_OPPONENT_BATTLEFIELD	1 {0} se invocó en el campo de tu oponente	0=card name e.g. 1 {Murloc Raider} was summoned into your opponent's battlefield
ACCESSIBILITY_GAMEPLAY_DIFF_MOVEMENT_CARDS_ADDED_TO_OPPONENT_BATTLEFIELD	{0} se invocaron en el campo de tu oponente	0=card names e.g. {2 Murloc Raider} were summoned into your opponent's battlefield
ACCESSIBILITY_GAMEPLAY_DIFF_MOVEMENT_CARDS_TAKEN_CONTROL_BY_PLAYER	tomaste el control de {0}	0=card names
ACCESSIBILITY_GAMEPLAY_DIFF_MOVEMENT_CARDS_TAKEN_CONTROL_BY_OPPONENT	tu oponente tomó el control de {0}	0=card names

ACCESSIBILITY_GAMEPLAY_DIFF_PLAYER_GAINED_SPELL_DAMAGE	ganaste {0} de daño extra con hechizos	0=spell damage
ACCESSIBILITY_GAMEPLAY_DIFF_PLAYER_LOST_SPELL_DAMAGE	perdiste {0} de daño extra con hechizos	0=spell damage
ACCESSIBILITY_GAMEPLAY_DIFF_OPPONENT_GAINED_SPELL_DAMAGE	tu oponente ganó {0} de daño extra con hechizos	0=spell damage
ACCESSIBILITY_GAMEPLAY_DIFF_OPPONENT_LOST_SPELL_DAMAGE	tu oponente perdió {0} de daño extra con hechizos	0=spell damage

ACCESSIBILITY_GAMEPLAY_DIFF_PLAYER_GAINED_MANA	ganaste {0} de maná	0=amount
ACCESSIBILITY_GAMEPLAY_DIFF_OPPONENT_GAINED_MANA	tu oponente ganó {0} de maná	0=amount
ACCESSIBILITY_GAMEPLAY_DIFF_PLAYER_GAINED_MANA_AND_EMPTY_MANA_CRYSTALS	ganaste {0} de maná y {1} |4(cristal de maná vacío,cristales de maná vacíos)	0=mana gained 1=empty mana crystals gained
ACCESSIBILITY_GAMEPLAY_DIFF_OPPONENT_GAINED_MANA_AND_EMPTY_MANA_CRYSTALS	Tu oponente ganó {0} de maná and {1} |4(cristal de maná vacío,cristales de maná vacíos)	0=mana gained 1=empty mana crystals gained
ACCESSIBILITY_GAMEPLAY_DIFF_PLAYER_GAINED_EMPTY_MANA_CRYSTALS	Ganaste {0} |4(cristal de maná vacío,cristales de maná vacíos)	0=amount
ACCESSIBILITY_GAMEPLAY_DIFF_OPPONENT_GAINED_EMPTY_MANA_CRYSTALS	Tu oponente ganó {0} |4(cristal de maná vacío,cristales de maná vacíos)	0=amount

ACCESSIBILITY_GAMEPLAY_SEE_PLAYER_HERO_HELP	pulsa {0} para examinar a tu héroe	0=v key
ACCESSIBILITY_GAMEPLAY_SEE_OPPONENT_HERO_HELP	pulsa {0} para examinar al héroe de tu oponente	0=f key
ACCESSIBILITY_GAMEPLAY_READ_CARDS_HELP	Utiliza las flechas arriba y abajo para leer las cartas	
ACCESSIBILITY_GAMEPLAY_CONFIRM_TO_ATTACK_TARGET	pulsa {0} para atacar a este objetivo	0=Enter key
ACCESSIBILITY_GAMEPLAY_PRESS_ENTER_TO_SUMMON_THIS_MINION	pulsa {0} para invocar a este esbirro	0=Enter key
ACCESSIBILITY_GAMEPLAY_OPPONENT_TURN_VOICE	tu oponente está jugando	
ACCESSIBILITY_GAMEPLAY_CONFIRM_END_TURN_HELP	Pulsa {0} o {1} para terminar tu turno. Pulsa cualquier otra tecla para cancelar	0=enter key 1=e key
ACCESSIBILITY_GAMEPLAY_SEE_VALID_OPTIONS	Usa {0} para revisar tus jugadas válidas	0=tab key
ACCESSIBILITY_GAMEPLAY_SEE_PLAYER_HAND_HELP	Pulsa {0} para mirar tu mano	0=c key
ACCESSIBILITY_GAMEPLAY_COUNT_OPPONENT_HAND_HELP	Pulsa {0} para conocer el número de cartas en la mano de tu oponente	0=Shift+c keys
ACCESSIBILITY_GAMEPLAY_SEE_PLAYER_MINIONS_HELP	Pulsa {0} para ver los esbirros que has invocado	0=b key
ACCESSIBILITY_GAMEPLAY_SEE_OPPONENT_MINIONS_HELP	pulsa {0} para ver los esbirros de tu oponente	0=g key
ACCESSIBILITY_GAMEPLAY_SEE_PLAYER_SECRETS_HELP	pulsa {0} para ver tus secretos	0=s key
ACCESSIBILITY_GAMEPLAY_COUNT_OPPONENT_SECRETS_HELP	pulsa {0} para ver los secretos colocados de tu oponente	0=Shift+s keys
ACCESSIBILITY_GAMEPLAY_READ_PLAYER_WEAPON_HELP	pulsa{0} para ver tu arma	0=w key
ACCESSIBILITY_GAMEPLAY_READ_OPPONENT_WEAPON_HELP	pulsa {0} para ver el arma de tu oponente	0=Shift+w keys
ACCESSIBILITY_GAMEPLAY_READ_PLAYER_HERO_POWER_HELP	pulsa {0} para ver tu poder de héroe	0=r key
ACCESSIBILITY_GAMEPLAY_READ_OPPONENT_HERO_POWER_HELP	pulsa {0} para ver el poder de héroe de tu oponente	0=Shift+r keys
ACCESSIBILITY_GAMEPLAY_COUNT_PLAYER_DECK_HELP	pulsa {0} para ver cuantas cartas quedan en tu mazo	0=d key
ACCESSIBILITY_GAMEPLAY_COUNT_OPPONENT_DECK_HELP	pulsa {0} para conocer el número de cartas en el mazo de tu oponente	0=Shift+d keys
ACCESSIBILITY_GAMEPLAY_READ_PLAYER_MANA_HELP	pulsa {0} para ver tu maná	0=a key
ACCESSIBILITY_GAMEPLAY_READ_OPPONENT_MANA_HELP	pulsa {0} para ver el maná de tu oponente	0=Shift+a key
ACCESSIBILITY_GAMEPLAY_READ_CARD_HELP	utiliza las flechas arriba y abajo para leer esta carta	
ACCESSIBILITY_GAMEPLAY_READ_CARD_TOOLTIP_HELP	pulsa {0} para obtener una descripción de las habilidades de esta carta	0=i key
ACCESSIBILITY_GAMEPLAY_PLAY_CARD_HELP	pulsa {0} para jugar esta carta	0=Enter key
ACCESSIBILITY_GAMEPLAY_SUMMON_MINION_HELP	pulsa {0} para invocar este esbirro	0=Enter key
ACCESSIBILITY_GAMEPLAY_CHOICE_MODE_HELP	Utiliza las flechas para revisar tus opciones. Pulsa {0} para escoger una	0=Enter key
ACCESSIBILITY_GAMEPLAY_CHOOSE_TARGET_HELP	Utiliza {0} o las teclas correspondientes a cada zona para desplazarte por tus posibles objetivos y presiona {1} para seleccionar uno o {2} para cancelar	0=Tab key 1=Enter key 2=Backspace key
ACCESSIBILITY_GAMEPLAY_ATTACK_WITH_MINION_HELP	Pulsa {0} para atacar con este esbirro	0=Enter key
ACCESSIBILITY_GAMEPLAY_ATTACK_WITH_HERO_HELP	Pulsa {0} para atacar con tu héroe	0=Enter key
ACCESSIBILITY_GAMEPLAY_USE_HERO_POWER_HELP	Pulsa {0} para usar tu poder de héroe	0=Enter key
ACCESSIBILITY_GAMEPLAY_READ_THROUGH_VALID_TARGETS	Usa {0} para ver tus objetivos válidos	0=Tab key
ACCESSIBILITY_GAMEPLAY_ATTACK_THIS_MINION_HELP	Pulsa {0} para atacar a este esbirro	0=Enter key
ACCESSIBILITY_GAMEPLAY_CANCEL_ATTACK_HELP	Pulsa {0} para cancelar el ataque	0=Backspace key
ACCESSIBILITY_GAMEPLAY_CANCEL_HELP	Pulsa {0} para cancelar	0=Backspace key
ACCESSIBILITY_GAMEPLAY_SUMMONING_CHOOSE_POSITION_HELP	Utiliza las flechas izquierda y derecha para elegir la posición de este esbirro	
ACCESSIBILITY_GAMEPLAY_OPEN_HISTORY_LOG_HELP	Pulsa {0} para abrir el historial	0=y key
ACCESSIBILITY_GAMEPLAY_READ_HISTORY_HELP	Utiliza las flechas arriba y abajo para leer el historial y pulsa {0} para cerrarlo	0=Backspace key
ACCESSIBILITY_GAMEPLAY_END_TURN_HELP	pulsa {0} para terminar tu turno	0=e key

ACCESSIBILITY_GAMEPLAY_HISTORY_LOG_EMPTY	aún nos e ha jugado nada	
ACCESSIBILITY_GAMEPLAY_HISTORY_LOG_ENTRY_FORMAT	{2} {0} de {1}	0=current entry 1=number of entries 2=entry e.g. {5} of {7} {your Hero took 5 damage}
ACCESSIBILITY_GAMEPLAY_HISTORY_LOG_CLOSE	Se detuvo la lectura del historial	

ACCESSIBILITY_GAMEPLAY_SPECIAL_STARTING_PLAYER_BATTLEFIELD	Tu campo comienza con {0}	0=starting cards e.g. Your battlefield starts with {4 Gates of Theramore}
ACCESSIBILITY_GAMEPLAY_SPECIAL_STARTING_OPPONENT_BATTLEFIELD	El campo de tu oponente comienza con {0}	0=starting cards e.g. Your opponent's battlefield starts with {1 Vicious Bear Trap}

ACCESSIBILITY_UI_POPUP	Ventana emergente	
ACCESSIBILITY_UI_REWARDS_TITLE	Recompensas	
ACCESSIBILITY_UI_UNKNOWN_POPUP	Esta ventana emergente aún no es accesible. Obtén ayuda de alguien que vea.	
ACCESSIBILITY_UI_UNKNOWN_DIALOG	Este cuadro de diálogo aún no es accesible. Obtén ayuda de alguien que vea	

ACCESSIBILITY_UI_ALERT_POPUP_TITLE	Ventana de alerta	

ACCESSIBILITY_UI_REWARD_SCROLL_TITLE	Has completado una misión	
ACCESSIBILITY_UI_REWARD_SCROLL_HELP	Utiliza las flechas para revisar tus recompensas	

ACCESSIBILITY_UI_QUEST_NOTIFICATION_POPUP_TITLE	Tienes {0} |4(misión,misiones)	0=number of quests
ACCESSIBILITY_UI_QUEST_NOTIFICATION_POPUP_HELP	Usa las flechas para leer tus misiones.	

ACCESSIBILITY_UI_WELCOME_QUESTS_HELP	Utiliza las flechas para leer tus |4(misión,misiones)	

ACCESSIBILITY_UI_REWARD_TITLE	¡Tienes una recompensa!	
ACCESSIBILITY_UI_REWARD_HELP	Utiliza las flechas para leer la recompensa	

ACCESSIBILITY_UI_RANKED_INTRO_POPUP	¡El nuevo sistema de ranking ya está aquí! Puedes encontrar más información sobre esto en línea.	

ACCESSIBILITY_UI_RANKED_BONUS_STARS_POPUP	¡Tu actuación en las partidas de Ranking de la temporada pasada te otorgó una bonificación de {0} estrellas!	0=star bonus amount

ACCESSIBILITY_UI_RECONNECT_HELPER_DIALOG_TITLE	Diálogo de reconexión	

ACCESSIBILITY_UI_SEASON_END_DIALOG_RANK_EARNED	{0} ha finalizado. Alcanzaste el rango de {1}	0=season name 1=rank name e.g. {July 2021 season} has ended. You achieved the rank of {Diamond 1}
ACCESSIBILITY_UI_SEASON_END_DIALOG_CHEST_EARNED	Has ganado un cofre de recompensas	
ACCESSIBILITY_UI_SEASON_END_DIALOG_CHEST_EARNED_HELP	Pulsa {0} para abrir	0=Enter key
ACCESSIBILITY_UI_SEASON_END_DIALOG_SEASON_WELCOME	La {0} ha comenzado!	0=season name e.g. The {August 2021 season} has begun!
ACCESSIBILITY_UI_SEASON_END_DIALOG_REDUCED_WELCOME	¡una nueva temporada ha comenzado!	
ACCESSIBILITY_UI_SEASON_END_DIALOG_REMINDER_CHEST	Gana {0} juegos esta temporada para recibir un cofre	0=number of games
ACCESSIBILITY_UI_SEASON_END_DIALOG_REMINDER_CARDBACK	Gana {0} juegos esta temporada para ganar tu dorso de carta de temporada	0=number of games

ACCESSIBILITY_UI_CARD_LIST_POPUP_HELP	Utiliza las flechas para leer las cartas.	

ACCESSIBILITY_UI_CHEST_REWARD_DISPLAY_TITLE	cofre de recompensa	
ACCESSIBILITY_UI_CHEST_REWARD_DISPLAY_HELP	Pulsa {0} para abrir tu cofre de recompensa	0=Enter key

ACCESSIBILITY_UI_RANKED_REWARD_DISPLAY	Obtuviste una recompensa de ranking, pero el modo de ranking no es accesible aún	

ACCESSIBILITY_UI_REWARD_BOXES_DISPLAY_TITLE	Obtuviste {0} |4(Paquete de recompensa,Paquetes de recompensa!	
ACCESSIBILITY_UI_REWARD_BOXES_DISPLAY_HELP	Utiliza las  flechas y {0} para abrir tus recompensas	0=Enter key

ACCESSIBILITY_UI_QUEST_NO_NAME_XP_ONLY	Misión de {0} XP	0=xp rewarded by quest. Note: these quests don't have a name
ACCESSIBILITY_UI_QUEST_REWARD_DESCRIPTION	Recompensas {0}	0=rewards e.g. Rewards {2 cards and 1 card pack from recent expansions}
ACCESSIBILITY_UI_QUEST_REWARD_CHOOSE_ONE_DESCRIPTION	Recompensas 1 de {0}	0=possible rewards e.g. Rewards 1 of {2 card packs from recent expansions, 2 cards and 2 hero skins}

ACCESSIBILITY_UI_REWARD_TYPE_REWARD_PACKAGE	Sobre de recompensa	
ACCESSIBILITY_UI_REWARD_TYPE_ONE_CARD_PACK	1 sobre de cartas	
ACCESSIBILITY_UI_REWARD_TYPE_ONE_CARD	1 carta	
ACCESSIBILITY_UI_REWARD_TYPE_ONE_CARD_BACK	1 dorso de carta	
ACCESSIBILITY_UI_REWARD_TYPE_ONE_MOUNT	1 montura	
ACCESSIBILITY_UI_REWARD_TYPE_ONE_MINI_SET	1 mini set	
ACCESSIBILITY_UI_REWARD_TYPE_UNKNOWN	1 recompensa desconocida	
ACCESSIBILITY_UI_REWARD_N_TICKETS	{0} |4(ticket,tickets)	0=number of tickets
ACCESSIBILITY_UI_REWARD_MINI_SET_WITH_N_CARDS	Mini set con {0} cartas	0=number of cards
ACCESSIBILITY_UI_REWARD_N_ARCANE_ORBS	{0} orbes arcanos	0=amount
ACCESSIBILITY_UI_REWARD_N_ARCANE_DUST	{0} polvo arcano	0=amount
ACCESSIBILITY_UI_REWARD_N_CARD_PACKS	{0} |4(sobre de cartas,sobres de cartas)	0=amount
ACCESSIBILITY_UI_REWARD_N_GOLD	{0} oro	0=amount
ACCESSIBILITY_UI_REWARD_CARD_FROM_CLASS	{0} |4(copia,copias) de 1 {1} carta	0=number of copies 1=class e.g. {2} copies of 1 {mage} card
ACCESSIBILITY_UI_REWARD_CORE_CARD_FROM_CLASS	{0} |4(copia,copias) de 1 carta de {1} del conjunto esencial	0=number of copies 1=class e.g. {2} copies of 1 core {mage} card
ACCESSIBILITY_UI_REWARD_GOLDEN_HERO	{0} edición oro	0=Hero name e.g. Golden Jaina Proudmoore
ACCESSIBILITY_UI_REWARD_CLASS_HERO	Héroe {0}	0=class e.g. Mage Hero
ACCESSIBILITY_UI_REWARD_CLASS_UNLOCK_PROGRESS	{0} de {1} héroes desbloqueados	0=number of unlocked Heroes 1=total number of Heroes
ACCESSIBILITY_UI_REWARD_CARD	{0} |4(,copias de 1) carta	0=number of copies
ACCESSIBILITY_UI_REWARD_N_HERO_SKINS	{0} |4(Skin de héroe,Skins de héroe)	0=amount
ACCESSIBILITY_UI_REWARD_N_CARD_BACKS	{0} |4(Dorso de carta,Dorsos de carta)	0=amount
ACCESSIBILITY_UI_REWARD_N_ARENA_TICKETS	{0} |4(Billete para la arena,Billetes para la arena)	0=amount
ACCESSIBILITY_UI_REWARD_N_RUNESTONES	{0} |4(Piedra rúnica,Piedras Rúnicas)	0=amount
ACCESSIBILITY_UI_REWARD_N_ADVENTURES	{0} |4(Aventura,Aventuras)	0=amount
ACCESSIBILITY_UI_REWARD_N_TAVERN_BRAWL_TICKETS	{0} |4(Billete para duelo de taberna,Billetes para duelo de taberna)	0=amount
ACCESSIBILITY_UI_REWARD_N_CUSTOM_COINS	{0} |4(Moneda personalizada,monedas personalizadas)	0=amount
ACCESSIBILITY_UI_REWARD_XP_BOOST	Multiplicador de experiencia del {0}%	0=amount
ACCESSIBILITY_UI_REWARD_N_MINI_SETS	{0} |4(Mini set,Mini sets)	0=amount
ACCESSIBILITY_UI_REWARD_N_BATTLEGROUNDS_HERO_SKINS	{0} |4(skin para el héroe del campo de batalla,skins para el héroe del campo de batalla)	0=amount
ACCESSIBILITY_UI_REWARD_N_BATTLEGROUNDS_GUIDE_SKINS	{0} |4(skin para el guía del campo de batalla,skins para el guía del campo de batalla)	0=amount

ACCESSIBILITY_SCREEN_GO_BACK	Atrás	

ACCESSIBILITY_SCREEN_FATAL_ERROR_SCREEN_TITLE	Pantalla de error grabe	

ACCESSIBILITY_SCREEN_END_GAME_SCREEN_HERO_LEVEL_UP	Tu héroe alcanzó el nivel {0}	0=level

ACCESSIBILITY_SCREEN_CHOOSE_ADVENTURER_SCREEN_TITLE	Pantalla de elección de héroe	
ACCESSIBILITY_SCREEN_CHOOSE_ADVENTURER_SCREEN_HERO_CHOSEN_HELP	Pulsa {0} para iniciar o {1} para volver al menú principal	0=Enter key 1=Backspace key

ACCESSIBILITY_SCREEN_ADVENTURE_SCREEN_TITLE	Pantalla de aventuras	
ACCESSIBILITY_SCREEN_ADVENTURE_SCREEN_CHOOSE_ADVENTURER_TITLE	Elige un héroe	
ACCESSIBILITY_SCREEN_ADVENTURE_SCREEN_ADVENTURE_MENU_TITLE	Menú de aventuras	
ACCESSIBILITY_SCREEN_ADVENTURE_SCREEN_ADVENTURE_MENU_PLAY_OPTION	Jugar	
ACCESSIBILITY_SCREEN_ADVENTURE_SCREEN_ADVENTURE_MENU_READ_DECK_OPTION	Ver tu mazo	
ACCESSIBILITY_SCREEN_ADVENTURE_SCREEN_ADVENTURE_MENU_RETIRE_OPTION	Retirarse	
ACCESSIBILITY_SCREEN_ADVENTURE_SCREEN_WAITING_FOR_VO_HELP	Esperando a que termine la narración 	
ACCESSIBILITY_SCREEN_ADVENTURE_SCREEN_READING_DECK_HELP	Utiliza las flechas para leer tus cartas	
ACCESSIBILITY_SCREEN_ADVENTURE_SCREEN_CANT_READ_DECK	No puedes ver tu mazo en esta aventura 	
ACCESSIBILITY_SCREEN_ADVENTURE_SCREEN_ADVENTURE_COMPLETE	Aventura completada	
ACCESSIBILITY_SCREEN_ADVENTURE_SCREEN_PROGRESS_MESSAGE	Estás en el  oponente {0} de {1}	0=current opponent number 1=number of opponents

ACCESSIBILITY_SCREEN_CHOOSE_ADVENTURE_SCREEN_MENU_TITLE	Elige una aventura	
ACCESSIBILITY_SCREEN_CHOOSE_ADVENTURE_SCREEN_MENU_BOOK_OF_HEROES_OPTION	Libro de los héroes	
ACCESSIBILITY_SCREEN_CHOOSE_ADVENTURE_SCREEN_PRACTICE_CHOOSE_DIFFICULTY_MENU_TITLE	Elige la dificultad de tu oponente	
ACCESSIBILITY_SCREEN_CHOOSE_ADVENTURE_SCREEN_PRACTICE_CHOOSE_DIFFICULTY_MENU_NORMAL_OPTION	Normal	
ACCESSIBILITY_SCREEN_CHOOSE_ADVENTURE_SCREEN_PRACTICE_CHOOSE_DIFFICULTY_MENU_EXPERT_OPTION	Experto	
ACCESSIBILITY_SCREEN_CHOOSE_ADVENTURE_SCREEN_PRACTICE_CHOOSE_EXPERT_LOCKED	Debes derrotar a todos los oponentes en modo normal para desbloquear el modo experto.	

ACCESSIBILITY_SCREEN_CHOOSE_OPPONENT_MENU_TITLE	Elige tu oponente	
ACCESSIBILITY_SCREEN_CHOOSE_OPPONENT_MENU_UNDEFEATED_OPPONENT_LABEL	{0} (no derrotado)	0=class name e.g. Undefeated {Demon Hunter}

ACCESSIBILITY_SCREEN_CHOOSE_DECK_TITLE	Elige tu mazo	

ACCESSIBILITY_TOAST_QUEST_PROGRESS_TOAST_TITLE	Diálogo de progresso de la misión	
ACCESSIBILITY_TOAST_QUEST_PROGRESS_TOAST_PROGRESS	El progreso actual es {0} de {1}	0=current progress 1=total

ACCESSIBILITY_TOAST_QUEST_TOAST_TITLE	Has completado una misión	

ACCESSIBILITY_TUTORIAL_LOADING_TUTORIAL	Cargando tutorial	
ACCESSIBILITY_TUTORIAL_WELCOME_BACK	Te doy la bienvenida al tutorial!	
ACCESSIBILITY_TUTORIAL_DEFEATED_HOGGER	Has derrotado a Hogger	
ACCESSIBILITY_TUTORIAL_DEFEATED_MILLHOUSE	Has derrotado a Molino Tormenta de Maná	
ACCESSIBILITY_TUTORIAL_DEFEATED_CHO	Has derrotado al Eremita Cho	
ACCESSIBILITY_TUTORIAL_DEFEATED_MUKLA	Has derrotado al Rei Mukla	
ACCESSIBILITY_TUTORIAL_DEFEATED_NESINGWARY	Has derrotado a Hemet Nesingwary	
ACCESSIBILITY_TUTORIAL_DEFEATED_ILLIDAN	Has derrotado a Illidan Tempestira	
ACCESSIBILITY_TUTORIAL_NEXT_HOGGER	Tu próximo oponente es Hogger	
ACCESSIBILITY_TUTORIAL_NEXT_MILLHOUSE	Tu próximo oponente es Molino Tormenta de Maná	
ACCESSIBILITY_TUTORIAL_NEXT_CHO	Tu próximo oponente es Eremita Cho	
ACCESSIBILITY_TUTORIAL_NEXT_MUKLA	Tu próximo oponente es el Rei Mukla	
ACCESSIBILITY_TUTORIAL_NEXT_NESINGWARY	Tu próximo oponente es Hemet Nesingwary	
ACCESSIBILITY_TUTORIAL_NEXT_ILLIDAN	Tu próximo y último oponente es Illidan Tempestira	

ACCESSIBILITY_TUTORIAL_NARRATOR_INTRO	Te enseñaré a jugar a través de un conjunto de seis tutoriales.	
ACCESSIBILITY_TUTORIAL_NARRATOR_HELP_KEYS	Si alguna vez te sientes perdido, pulsa {0}. Incluso después del tutorial o cuando navegues por los menús, siempre puedes pulsar {0} cuando necesites ayuda.	0=F1 key
ACCESSIBILITY_TUTORIAL_NARRATOR_INTRO_END	Muy bien, vamos allá	
ACCESSIBILITY_TUTORIAL_FREE_STARTING_PACK	Aquí tienes un sobre básico de cartas de mago para que comiences. Presiona {0} para abrirlo.	0=Enter key
ACCESSIBILITY_TUTORIAL_NICE_WORK	Buen trabajo!	
ACCESSIBILITY_TUTORIAL_NICE_JOB	Eso es!	
ACCESSIBILITY_TUTORIAL_NICE_ONE	Muy bien!	
ACCESSIBILITY_TUTORIAL_GOOD_JOB	Bien hecho!	
ACCESSIBILITY_TUTORIAL_YOU_GOT_IT	Lo entendiste!	
ACCESSIBILITY_TUTORIAL_REMEMBER_HOW_TO_DO_IT	¿Recuerdas como se hace?	
ACCESSIBILITY_TUTORIAL_REMEMBER_HOW_TO_DO_THAT	¿Recuerdas cómo hacer eso?	
ACCESSIBILITY_TUTORIAL_TRY_IT_OUT	¡Inténtalo!	
ACCESSIBILITY_TUTORIAL_ALL_RIGHT	¡Eso es!	
ACCESSIBILITY_TUTORIAL_LETS_LEARN_HOW	Vamos a ver como hacerlo	
ACCESSIBILITY_TUTORIAL_CAN_YOU_DO_IT	¿Puedes hacerlo?	
ACCESSIBILITY_TUTORIAL_THINK_YOU_CAN_DO_IT	¿Crees que puedes hacerlo?	
ACCESSIBILITY_TUTORIAL_GOT_IT	Lo entendiste	
ACCESSIBILITY_TUTORIAL_NO_ENDTURN_HP	¡Todavía no! Usa tu poder de héroe. Presiona {0} para seleccionarlo	0=r key

ACCESSIBILITY_TUTORIAL_HOGGER_START	Tu primer oponente es un gnoll llamado Hogger. Jugarás como la poderosa maga Jaina Valiente.	
ACCESSIBILITY_TUTORIAL_HOGGER_FORCE_CARD_READ	Utiliza las flechas arriba y abajo para leer esta carta	
ACCESSIBILITY_TUTORIAL_HOGGER_SUMMON_MINION_FIRST	Invoca al esbirro que acabas de conseguir	
ACCESSIBILITY_TUTORIAL_HOGGER_FORCE_LOOK_AT_OPPONENT_MINIONS_FIRST	Pulsa {0} y luego utiliza las flechas para ver los esbirros de tu oponente	0=g key
ACCESSIBILITY_TUTORIAL_HOGGER_2_0	Cuando comienza un turno, siempre empiezas robando una carta de tu mazo. Veamos que  carta acabas de robar	
ACCESSIBILITY_TUTORIAL_HOGGER_2_1	Pulsa {0} para ver las cartas en tu mano	0=c key
ACCESSIBILITY_TUTORIAL_HOGGER_2_2	Bien, entonces... Esta carta es un esbirro llamado Asaltante Múrloc	
ACCESSIBILITY_TUTORIAL_HOGGER_2_2B	Los esbirros son criaturas que puedes invocar al campo de batalla para luchar por tu héroe.	
ACCESSIBILITY_TUTORIAL_HOGGER_2_2D	Este cuesta 1 maná para invocarse y tiene 2 puntos de ataque y 1 de salud.	
ACCESSIBILITY_TUTORIAL_HOGGER_2_3	Empecemos por invocar a este esbirro	
ACCESSIBILITY_TUTORIAL_HOGGER_2_4	Pulsa {0} para hacerlo	0=Enter key
ACCESSIBILITY_TUTORIAL_HOGGER_2_5	Pulsa {0} para confirmar o {1} para cancelar	0=Enter key 1=Backspace key
ACCESSIBILITY_TUTORIAL_HOGGER_2_6	Los esbirros deben esperar un turno para atacar una vez que son invocados, por lo que no nos queda nada por hacer.	
ACCESSIBILITY_TUTORIAL_HOGGER_3_0	El esbirro de tu oponente atacó a tu héroe, por lo que recibiste algo de daño.	
ACCESSIBILITY_TUTORIAL_HOGGER_3_1	Vamos a ver cuanta salud nos queda	
ACCESSIBILITY_TUTORIAL_HOGGER_3_2	Usa las flechas arriba y abajo para ver las estadísticas de tu héroe	
ACCESSIBILITY_TUTORIAL_HOGGER_3_2_HELP	Pulsa {0} y luego usa las flechas para averiguar cuánta salud tiene tu héroe.	0=v key
ACCESSIBILITY_TUTORIAL_HOGGER_3_3	Si tu héroe se queda sin salud, pierdes. Pero tranquilo! Con 28 de salud aún tienes para rato	
ACCESSIBILITY_TUTORIAL_HOGGER_3_4	Veamos ahora al héroe de tu oponente. Pulsa {0}	0=f key
ACCESSIBILITY_TUTORIAL_HOGGER_3_5	¿Puedes ver cuánta salud tiene?	
ACCESSIBILITY_TUTORIAL_HOGGER_3_5_HELP	Utiliza las flechas arriba y abajo para ver las estadísticas del héroe de tu oponente	
ACCESSIBILITY_TUTORIAL_HOGGER_3_6	Una vez que el héroe de tu oponente se quede sin salud, ganas	
ACCESSIBILITY_TUTORIAL_HOGGER_3_7	Sigamos adelante	
ACCESSIBILITY_TUTORIAL_HOGGER_4_1	Parece que tienes otro esbirro. ¿Puedes invocar a este tú mismo?	
ACCESSIBILITY_TUTORIAL_HOGGER_4_1_HELP	Pulsa {0} y luego {1} para convocar a tu esbirro.	0=c key 1=Enter key
ACCESSIBILITY_TUTORIAL_HOGGER_4_2	Cuando ya tienes esbirros en el campo de batalla, puedes usar las flechas izquierda y derecha para seleccionar dónde posicionar el nuevo esbirro	
ACCESSIBILITY_TUTORIAL_HOGGER_4_4	Ahora tienes dos esbirros en el campo de batalla. Este último acaba de ser invocado, por lo que debe esperar un turno para atacar.	
ACCESSIBILITY_TUTORIAL_HOGGER_4_5	Vamos a aprender como navegar por el campo	
ACCESSIBILITY_TUTORIAL_HOGGER_4_6	Utiliza las flechas izquierda y derecha para navegar por tus esbirros	
ACCESSIBILITY_TUTORIAL_HOGGER_4_6_HELP	Pulsa {0} y luego utiliza las flechas para navegar por tus esbirros invocados.	0=b key
ACCESSIBILITY_TUTORIAL_HOGGER_4_8	Veamos ahora a los esbirros de tu oponente. Pulsa {0} para hacerlo	0=g key
ACCESSIBILITY_TUTORIAL_HOGGER_4_9	¿Puedes ver este esbirro por ti mismo?	
ACCESSIBILITY_TUTORIAL_HOGGER_4_9_HELP	Utiliza las flechas arriba y abajo para ver las estadísticas de los esbirros de tu oponente	
ACCESSIBILITY_TUTORIAL_HOGGER_4_10	Ahora intentemos atacar a este esbirro	
ACCESSIBILITY_TUTORIAL_HOGGER_4_11	Selecciona el asaltante múrloc que invocaste en el último turno.	
ACCESSIBILITY_TUTORIAL_HOGGER_4_11_HELP	Pulsa {0} para seleccionar a tu esbirro y luego {1} para lanzar un ataque.	0=b key 1=Enter key
ACCESSIBILITY_TUTORIAL_HOGGER_4_12	Pulsa {0} para atacar con este esbirro.	0=Enter key
ACCESSIBILITY_TUTORIAL_HOGGER_4_13	¿Puedes atacar al esbirro de tu oponente?	
ACCESSIBILITY_TUTORIAL_HOGGER_4_13_HELP	Pulsa {0} y luego {1} para atacar al esbirro de tu oponente.	0=g key 1=Enter key
ACCESSIBILITY_TUTORIAL_HOGGER_4_16	Ambos esbirros tenían 2 puntos de ataque y 1 de salud, por lo que se destruyeron entre sí.	
ACCESSIBILITY_TUTORIAL_HOGGER_4_17	Tu otro esbirro todavía se encuentra agotado así que no queda nada por hacer. ¿Recuerdas cómo terminar tu turno?	
ACCESSIBILITY_TUTORIAL_HOGGER_6_1	Parece que conseguiste otro esbirro	
ACCESSIBILITY_TUTORIAL_HOGGER_6_2	Esto significa que tienes dos opciones posibles en este momento	
ACCESSIBILITY_TUTORIAL_HOGGER_6_3	Puedes invocar al esbirro que acabas de recibir o usar el que invocaste en el último turno para atacar	
ACCESSIBILITY_TUTORIAL_HOGGER_6_4	Una forma de hacerlo sería pulsar teclas como {0} para mirar tu mano o {1} para mirar a tus esbirros invocados.	0=c key 1=b key
ACCESSIBILITY_TUTORIAL_HOGGER_6_5	Sin embargo, hay una forma más sencilla de hacerlo.	
ACCESSIBILITY_TUTORIAL_HOGGER_6_6	Pulsa {0}	0=Tab key
ACCESSIBILITY_TUTORIAL_HOGGER_6_7	Ahora estás viendo tu primera opción, que sería invocar al esbirro que acabas de robar.	
ACCESSIBILITY_TUTORIAL_HOGGER_6_8	Prueba pulsar {0} nuevamente	0=Tab key
ACCESSIBILITY_TUTORIAL_HOGGER_6_9	Ahora estás viendo tu segunda opción, que sería atacar con el esbirro que invocaste en el último turno.	
ACCESSIBILITY_TUTORIAL_HOGGER_6_10	Siempre puedes pulsar {0} para revisar tus opciones válidas, ¡así que asegúrate de recordar esta tecla!	0=key
ACCESSIBILITY_TUTORIAL_HOGGER_6_12	Bien. Comencemos por invocar al esbirro que acabamos de robar	
ACCESSIBILITY_TUTORIAL_HOGGER_6_12_HELP	Pulsa {0} o {1} y luego {2} para invocar a tu esbirro.	0=Tab key 1=c key 2=Enter key
ACCESSIBILITY_TUTORIAL_HOGGER_6_13	Ahora intentemos atacar con nuestro otro esbirro	
ACCESSIBILITY_TUTORIAL_HOGGER_6_13_HELP	Pulsa {0} o {1} para seleccionar a tu esbirro y {2} para lanzar un ataque.	0=Tab key 1=b key 2=Enter key
ACCESSIBILITY_TUTORIAL_HOGGER_6_14	Ahora tienes otra elección que hacer. Puedes atacar a uno de los esbirros de tu oponente o a su propio héroe	
ACCESSIBILITY_TUTORIAL_HOGGER_6_15	Puedes pulsar {0} para revisar tus objetivos válidos o seleccionar tu objetivo directamente con {1} o {2}	0=Tab key 1=g key 2=f key
ACCESSIBILITY_TUTORIAL_HOGGER_6_16	Adelante, elige un objetivo para atacar.	
ACCESSIBILITY_TUTORIAL_HOGGER_6_16_HELP	Pulsa {0} y luego {1} para lanzar un ataque.	0=Tab key 1=Enter key
ACCESSIBILITY_TUTORIAL_HOGGER_6_21	¡Estamos listos para terminar nuestro turno!	
ACCESSIBILITY_TUTORIAL_HOGGER_8_1	Dejaré que sigas jugando solo. Cualquier cosa avísame si necesitas algo	

ACCESSIBILITY_TUTORIAL_MILLHOUSE_SEE_MANA_HELP	Pulsa {0} en cualquier momento para ver cuánto maná tienes	0=a key

ACCESSIBILITY_TUTORIAL_CHO_1	Este médico vudú curó al héroe de tu oponente	
ACCESSIBILITY_TUTORIAL06_HELP_02	Cuando los esbirros se atacan entre sí, ambos reciben daño.	

ACCESSIBILITY_TUTORIAL_MUKLA_START	En esta pelea, verás algunas cartas con habilidades que no habías visto antes.	
ACCESSIBILITY_TUTORIAL_MUKLA_START_B	Si te encuentras con algo que no entiendes al ver las estadísticas de una carta, como Cargar o provocar, pulsa {0} para obtener más información.	0=i key
ACCESSIBILITY_TUTORIAL_MUKLA_START_C	Pulsa {0}  para comenzar.	0=Enter key
ACCESSIBILITY_TUTORIAL_MUKLA_TAUNT_HELP	Este gorila que acaba de invocar tu oponente tiene una habilidad llamada Provocar	
ACCESSIBILITY_TUTORIAL_MUKLA_TAUNT_HELP_B	Los esbirros con Provocar siempre deben ser destruídos antes de que puedas atacar a alguien más.	
ACCESSIBILITY_TUTORIAL_MUKLA_TAUNT_HELP_C	Provocar es una habilidad importante, ya que puede usarse para proteger a tu héroe.	

ACCESSIBILITY_TUTORIAL_HEMET_HERO_POWER_HELP	A partir de este momento, tu héroe y el de tu oponente normalmente tendrán un poder de héroe.	
ACCESSIBILITY_TUTORIAL_HEMET_HERO_POWER_HELP_B	Cada héroe tiene su propio poder de héroe, que puede ser  usado una vez por turno.	
ACCESSIBILITY_TUTORIAL_HEMET_HERO_POWER_HELP_C	Siempre puedes pulsar {0} para ver tu poder de héroe y {1} para ver el de tu oponente	0=hero power key 1=opponent hero power key

	ACCESSIBILITY_TUTORIAL05_HELP_03	Esta pelea es totalmente injusta. Culpa a los terribles diseñadores del juego	
ACCESSIBILITY_TUTORIAL05_HELP_04	¡Tus esbirros con la habilidad provocar pueden protegerte de los ataques!	
ACCESSIBILITY_TUTORIAL_ILLIDAN_WEAPON_EQUIPPED_HELP	Parece que tu oponente equipó un arma.	
ACCESSIBILITY_TUTORIAL_ILLIDAN_WEAPON_EQUIPPED_HELP_B	Las armas son cartas especiales que pueden ser equipadas por los héroes.	
ACCESSIBILITY_TUTORIAL_ILLIDAN_WEAPON_EQUIPPED_HELP_C	Cada arma tiene un valor de ataque y otro de durabilidad.	
ACCESSIBILITY_TUTORIAL_ILLIDAN_WEAPON_EQUIPPED_HELP_D	Una vez equipados, los héroes pueden atacar a otros personajes durante su turno.	
ACCESSIBILITY_TUTORIAL_ILLIDAN_WEAPON_EQUIPPED_HELP_E	Tu oponente equipó Gujas de guerra de Azzinoth:: un arma con 2 de ataque y 2 de durabilidad	
ACCESSIBILITY_TUTORIAL_ILLIDAN_WEAPON_EQUIPPED_HELP_F	Esto significa que el héroe de tu oponente tendrá un arma con 2 de ataque durante su turno y podrá atacar a cualquiera de tus personajes.	
ACCESSIBILITY_TUTORIAL_ILLIDAN_WEAPON_EQUIPPED_HELP_G	Los magos no suelen utilizar armas, pero podrás usar algunas más adelante una vez que hayas desbloqueado otras clases	
ACCESSIBILITY_TUTORIAL_ILLIDAN_WEAPON_EQUIPPED_HELP_H	Puedes pulsar {0} en cualquier momento para ver tu arma o {1} para ver la de tu oponente	0=weapon key 1=opponent weapon key
ACCESSIBILITY_TUTORIAL_ILLIDAN_WEAPON_DURABILITY_HELP	¿Escuchas ese sonido? Las armas pierden durabilidad cada vez que son utilizadas	
ACCESSIBILITY_TUTORIAL_ILLIDAN_WEAPON_DURABILITY_HELP_B	Una vez que alcanzan 0 de durabilidad, se rompen y el héroe ya no puede atacar con ellas	

ACCESSIBILITY_IN_GAME_TUTORIAL_MULLIGAN_FIRST_TIME	Todo juego normal comienza con la fase de mulligan	
ACCESSIBILITY_IN_GAME_TUTORIAL_MULLIGAN_FIRST_TIME_B	En esta fase, ambos jugadores pueden reemplazar cartas de su mano inicial con otras cartas aleatorias de su mazo	
ACCESSIBILITY_IN_GAME_TUTORIAL_MULLIGAN_FIRST_TIME_C	Utiliza las flechas direccionales o {0} para ver tu mano inicial	0=Tab key
ACCESSIBILITY_IN_GAME_TUTORIAL_MULLIGAN_FIRST_TIME_D	Si ves una carta que no te gusta o interesa, pulsa {0} para marcarla y que sea  reemplazada	0=Spacebar key
ACCESSIBILITY_IN_GAME_TUTORIAL_MULLIGAN_FIRST_TIME_E	Una vez que hayas marcado todas las cartas que deseas reemplazar, pulsa {0} para robar nuevas cartas e iniciar el juego	0=Enter key

